............
....###.....
...##.#.####
..##..###..#
.##........#
.#......#..#
.###..###...
...#..#....#
..##.##.#.##
..#......##.
..#.....##..
..###@###...
....#.#.....