............
....#.#.....
....#.#.####
..##..###..#
.##........#
....#@..#..#
.##....##...
......#..!.#
..##.##.#.##
###......##.
..#.....##..
..###.###...
....#.#.....
